1111111111111111111111111111111111
1E0000000000000C00000C000000000001
1111111111111111111001000001010101
1010010010101010001111111001010101
1P0000000C00C0000101000010010000C1
1000000000000000011110001001000001
10000000000C0000000000001001000001
100000000000000C00000C001001000001
1011111100000000111111111001010101
1010000000000000000001000001010101
101000000C00C0000000000000010000C1
1111111111111111111111111111111111