111111
1P0001
1C0011
1E0001
111111