11111111111
1M011E11001
10010001M01
1111BCB1111
11B1B001011
1B00BBB00C1
10BBB00BB01
11P0B00B011
11111111111