11111111111
10000111101
1011110P101
10100B00101
111C00B1101
11001111101
110BC0B0111
110B0B00E11
11111111111
11111111111