1111111111
1000111101
10001E0111
111110C011
110C1BBB11
110B00B011
11010P0011
1101101111
1100001001
1111111001
1111111111