111111111111111111111111111111
1E0000000000000000000000000001
111111111111111110111111111101
100000000000000000000000000001
1000000000M000000000CC0C0CCC01
10011111111111101010CBCCC0C001
10B00000M000B00010100000000001
10000000000B1111101CCC11111111
1P000000000000000C000000000001
101111BB111111CCCCCCC111111101
1000000000000C0000000000000001
111111111111111111111111111111