111111111111111111111111111111
1E000000000M000000000000000001
1000CC0010CC00000010CCCCCCCC01
10000000100011111000CM0CC0MC01
1010CC0B100000100010C0C00C0C01
10111111111111100010CCCCCCCC01
10000000000M000B00100000000001
101111111110101110111111111111
1P000000000010000C000M00000001
10CC001111111111CCCC1111111101
1000000000000C0000000000000001
111111111111111111111111111111