111111111111111111111111111111
1E0000000000000000000000000001
111111111111111110111111111101
100000000000000000000000000001
10100010001000101010CC0C0CCC01
10011111111111101010CBCCC0C001
10B000000000B00010100000000001
100011111111111110111111111111
1P000000000000000C000000000001
101111111111111111111111111101
1000000000000C0000000000000001
111111111111111111111111111111