1111111111111111111111111111111
1E00000000000000000000000000001
1111111111111111111111100001111
1000000000000000000000000001C01
1011111111111111111100011111C11
1000000000000000000000010001C11
1011CCCC11111100001111111111C11
10111111111000111CCCCCCCCCCC0C1
1P00000000000000000000000000001
1011111111111111111111111111111
1000000000000000000000000000001
1111111111111111111111111111111